1111111111111
100100000001
1000011111001
1PP011EE00001
1111111111111
